==================================================
==================================================
==================================================
==================================================
==================================================
==================================================
==================================================
=========###==========================###=========
========####========================######========
======######========================########======
====#########===#################===########======
====####################################==========
==========#############################===========
===========###########################============
===========###########################============
===========#####======######======####============
==================================================
======================######======================
============#########################=============
==================================================
==================================================
==================================================
================#################=================
==============#####################===============
=============#######################==============
========########===###########===########=========
=======#########===###########===########=========
=========#######====#########====######===========
============###===================###=============
==================================================
==================================================
==================================================
==================================================
==================================================
==================================================
==================================================