==================================================
==========##############################==========
========##==============================##========
=======#==================================#=======
======#====================================#======
===######================================######===
==================================================
======#====================================#======
====##======================================##====
==================================================
==================================================
===############################################===
==================================================
==================================================
==================================================
==================================================
==================================================
===############################################===
==================================================
==================================================
==================================================
==================================================
==================================================
===############################################===
==================================================
==================================================
==================================================
==================================================
==================================================
===############################################===
==================================================
==================================================
==================================================
==================================================
==================================================
==================================================