==================================================
==================================================
==================================================
==================================================
==================================================
==================================================
==================================================
===========#============================#=========
==========###==========================###========
=========####========================######=======
=======######========================########=====
=====#########===#################===########=====
=====####################################=========
===========#############################==========
============###########################===========
============###########################===========
============#####======######======####===========
==================================================
=======================######=====================
=============#########################============
==================================================
==================================================
==================================================
=================###==##===##==###================
===============#####==###==##==#####==============
==============#######################=============
=========########===###########===########========
========#########===###########===########========
==========#######====#########====######==========
=============###===================###============
==================================================
==================================================
==================================================
==================================================
==================================================
==================================================
